WWWWWWWWWWWWWWWWWWWW
WCCCCCCCCCCCCCCCCCFW
WCWWWWCWWWWWWCWWWWCW
WCWCCCCCCCCCCCCCCWCW
WCWCWWCWWGGWWCWWCWCW
WCCCCCCW GG WCCCCCCW
WCWCWWCWWWWWWCWWCWCW
WCWCCCCCCCCCCCCCCWCW
WCWWWWWCWWWWCWWWWWCW
WFCCCCCCCCPCCCCCCCCW
WWWWWWWWWWWWWWWWWWWW
