WWWWWWWWWWWWWWWWWWWW
WFCCCWCCCCCCCCWCCCCW
WCWWCWCWWWWWWCWCWWCW
WCWCCCCCCCCCCCCCCWCW
WCWCWWCWW  WWCWWCWCW
WCCCCCCWGGGGWCCCCCCW
WCWCWWCWWWWWWCWWCWCW
WCWCCCCCCCCCCCCCCWCW
WCWWCWCWWWWWWCWCWWCW
WCCCCWCCCCPCCCWCCCFW
WWWWWWWWWWWWWWWWWWWW