WWWWWWWWWWWWWWWWWWWW
WFCCCWCCGGGGCCWCCCCW
WCWWCWCWWWWWWCWCWWCW
WCWCCCCCCCCCCCCCCWCW
WCWCWWCWWWWWWCWWCWCW
WCCCCCCW    WCCCCCCW
WCWCWWCWWWWWWCWWCWCW
WCWCCCCCCCCCCCCCCWCW
WCWWCWCWWWWWWCWCWWCW
WCCCCWCCCCPCCCWCCCFW
WWWWWWWWWWWWWWWWWWWW