WWWWWWWWWWWWWWWWWWWW
WFCCCWCCCCCCCCWCCCCW
WCWWCWCWWWWWWCWCWWCW
WCWCCCCCCCCCCCCCCWCW
WCWCWWCWWGGWWCWWCWCW
WCCCCCCW GG WCCCCCCW
WCWCWWCWWWWWWCWWCWCW
WCWCCCCCCCCCCCCCCWCW
WCWWCWCWWWWWWCWCWWCW
WCCCCWCCCCPCCCWCCCFW
WWWWWWWWWWWWWWWWWWWW