WWWWWWWWWWWWWWWWWWWW
WCCCCCCCCCCCCCCCCCCW
WCWWWWWCWWWWCWWWWWCW
WCCCCCCCCCCCCCCCCCCW
WCWWWWCWWGGWWCWWWWCW
WFCCCCCW GG WCCCCCFW
WCWWWWCWWWWWWCWWWWCW
WCCCCCCCCCCCCCCCCCCW
WCWWWWWCWWWWCWWWWWCW
WCCCCCCCCCPCCCCCCCCW
WWWWWWWWWWWWWWWWWWWW
