WWWWWWWWWWWWWWWWWWWW
W    W        W    W
W WW W WWWWWW W WW W
W W              W W
W W WW WWGGWW WW W W
W      W GG W      W
W W WW WWWWWW WW W W
W W              W W
W WW W WWWWWW W WW W
W    WC   P  CW    W
WWWWWWWWWWWWWWWWWWWW
